ID	DESCRIPTION	DESCRIPTION_ID
AK	Alaska	Alaska (AK)
AL	Alabama Sales Tax	Alabama Sales Tax (AL)
AL1	Alabama Sales Tax	Alabama Sales Tax (AL1)
AL10	Alabama Sales Tax	Alabama Sales Tax (AL10)
AL11	Alabama Sales Tax	Alabama Sales Tax (AL11)
AL12	Alabama Sales Tax	Alabama Sales Tax (AL12)
AL13	Alabama Sales Tax	Alabama Sales Tax (AL13)
AL14	Alabama Sales Tax	Alabama Sales Tax (AL14)
AL15	Alabama Sales Tax	Alabama Sales Tax (AL15)
AL16	Alabama Sales Tax	Alabama Sales Tax (AL16)
AL17	Alabama Sales Tax	Alabama Sales Tax (AL17)
AL18	Alabama Sales Tax	Alabama Sales Tax (AL18)
AL19	Alabama Sales Tax	Alabama Sales Tax (AL19)
AL2	Alabama Sales Tax	Alabama Sales Tax (AL2)
AL3	Alabama Sales Tax	Alabama Sales Tax (AL3)
AL4	Alabama Sales Tax	Alabama Sales Tax (AL4)
AL5	Alabama Sales Tax	Alabama Sales Tax (AL5)
AL6	Alabama Sales Tax	Alabama Sales Tax (AL6)
AL7	Alabama Sales Tax	Alabama Sales Tax (AL7)
AL8	Alabama Sales Tax	Alabama Sales Tax (AL8)
AL9	Alabama Sales Tax	Alabama Sales Tax (AL9)
AR	Arkansas Sales Tax	Arkansas Sales Tax (AR)
AR1	Arkansas Sales Tax	Arkansas Sales Tax (AR1)
AR10	Arkansas Sales Tax	Arkansas Sales Tax (AR10)
AR11	Arkansas Sales Tax	Arkansas Sales Tax (AR11)
AR12	Arkansas Sales Tax	Arkansas Sales Tax (AR12)
AR13	Arkansas Sales Tax	Arkansas Sales Tax (AR13)
AR14	Arkansas Sales Tax	Arkansas Sales Tax (AR14)
AR15	Arkansas Sales Tax	Arkansas Sales Tax (AR15)
AR16	Arkansas Sales Tax	Arkansas Sales Tax (AR16)
AR17	Arkansas Sales Tax	Arkansas Sales Tax (AR17)
AR18	Arkansas Sales Tax	Arkansas Sales Tax (AR18)
AR19	Arkansas Sales Tax	Arkansas Sales Tax (AR19)
AR2	Arkansas Sales Tax	Arkansas Sales Tax (AR2)
AR20	Arkansas Sales Tax	Arkansas Sales Tax (AR20)
AR21	Arkansas Sales Tax	Arkansas Sales Tax (AR21)
AR22	Arkansas Sales Tax	Arkansas Sales Tax (AR22)
AR23	Arkansas Sales Tax	Arkansas Sales Tax (AR23)
AR24	Arkansas Sales Tax	Arkansas Sales Tax (AR24)
AR3	Arkansas Sales Tax	Arkansas Sales Tax (AR3)
AR4	Arkansas Sales Tax	Arkansas Sales Tax (AR4)
AR5	Arkansas Sales Tax	Arkansas Sales Tax (AR5)
AR6	Arkansas Sales Tax	Arkansas Sales Tax (AR6)
AR7	Arkansas Sales Tax	Arkansas Sales Tax (AR7)
AR8	Arkansas Sales Tax	Arkansas Sales Tax (AR8)
AR9	Arkansas Sales Tax	Arkansas Sales Tax (AR9)
AZ	Arizona Sales Tax	Arizona Sales Tax (AZ)
AZ1	Arizona Sales Tax	Arizona Sales Tax (AZ1)
AZ10	Arizona Sales Tax	Arizona Sales Tax (AZ10)
AZ11	Arizona Sales Tax	Arizona Sales Tax (AZ11)
AZ12	Arizona Sales Tax	Arizona Sales Tax (AZ12)
AZ13	Arizona Sales Tax	Arizona Sales Tax (AZ13)
AZ14	Arizona Sales Tax	Arizona Sales Tax (AZ14)
AZ15	Arizona Sales Tax	Arizona Sales Tax (AZ15)
AZ16	Arizona Sales Tax	Arizona Sales Tax (AZ16)
AZ17	Arizona Sales Tax	Arizona Sales Tax (AZ17)
AZ18	Arizona Sales Tax	Arizona Sales Tax (AZ18)
AZ19	Arizona Sales Tax	Arizona Sales Tax (AZ19)
AZ2	Arizona Sales Tax	Arizona Sales Tax (AZ2)
AZ20	Arizona Sales Tax	Arizona Sales Tax (AZ20)
AZ21	Arizona Sales Tax	Arizona Sales Tax (AZ21)
AZ22	Arizona Sales Tax	Arizona Sales Tax (AZ22)
AZ23	Arizona Sales Tax	Arizona Sales Tax (AZ23)
AZ24	Arizona Sales Tax	Arizona Sales Tax (AZ24)
AZ25	Arizona Sales Tax	Arizona Sales Tax (AZ25)
AZ26	Arizona Sales Tax	Arizona Sales Tax (AZ26)
AZ27	Arizona Sales Tax	Arizona Sales Tax (AZ27)
AZ3	Arizona Sales Tax	Arizona Sales Tax (AZ3)
AZ4	Arizona Sales Tax	Arizona Sales Tax (AZ4)
AZ5	Arizona Sales Tax	Arizona Sales Tax (AZ5)
AZ6	Arizona Sales Tax	Arizona Sales Tax (AZ6)
AZ7	Arizona Sales Tax	Arizona Sales Tax (AZ7)
AZ8	Arizona Sales Tax	Arizona Sales Tax (AZ8)
AZ9	Arizona Sales Tax	Arizona Sales Tax (AZ9)
CA	California Sales Tax	California Sales Tax (CA)
CA1	California Sales Tax	California Sales Tax (CA1)
CA10	California Sales Tax	California Sales Tax (CA10)
CA11	California Sales Tax	California Sales Tax (CA11)
CA12	California Sales Tax	California Sales Tax (CA12)
CA13	California Sales Tax	California Sales Tax (CA13)
CA2	California Sales Tax	California Sales Tax (CA2)
CA3	California Sales Tax	California Sales Tax (CA3)
CA4	California Sales Tax	California Sales Tax (CA4)
CA5	California Sales Tax	California Sales Tax (CA5)
CA6	California Sales Tax	California Sales Tax (CA6)
CA7	California Sales Tax	California Sales Tax (CA7)
CA8	California Sales Tax	California Sales Tax (CA8)
CA9	California Sales Tax	California Sales Tax (CA9)
CO	Colorada Sales Tax	Colorada Sales Tax (CO)
CO1	Colorada Sales Tax	Colorada Sales Tax (CO1)
CO10	Colorada Sales Tax	Colorada Sales Tax (CO10)
CO11	Colorada Sales Tax	Colorada Sales Tax (CO11)
CO12	Colorada Sales Tax	Colorada Sales Tax (CO12)
CO13	Colorada Sales Tax	Colorada Sales Tax (CO13)
CO14	Colorada Sales Tax	Colorada Sales Tax (CO14)
CO15	Colorado Sales Tax	Colorado Sales Tax (CO15)
CO16	Colorado Sales Tax	Colorado Sales Tax (CO16)
CO17	Colorado Sales Tax	Colorado Sales Tax (CO17)
CO2	Colorada Sales Tax	Colorada Sales Tax (CO2)
CO3	Colorada Sales Tax	Colorada Sales Tax (CO3)
CO4	Colorada Sales Tax	Colorada Sales Tax (CO4)
CO5	Colorada Sales Tax	Colorada Sales Tax (CO5)
CO6	Colorada Sales Tax	Colorada Sales Tax (CO6)
CO7	Colorada Sales Tax	Colorada Sales Tax (CO7)
CO8	Colorada Sales Tax	Colorada Sales Tax (CO8)
CO9	Colorada Sales Tax	Colorada Sales Tax (CO9)
CT	Connecticut Sales Tax	Connecticut Sales Tax (CT)
DC	District of Columbia Sales Tax	District of Columbia Sales Tax (DC)
DE	Delaware	Delaware (DE)
EX	Exempt	Exempt (EX)
FL	Florida Sales Tax	Florida Sales Tax (FL)
FL1	Florida Sales Tax	Florida Sales Tax (FL1)
FL2	Florida Sales Tax	Florida Sales Tax (FL2)
FL3	Florida Sales Tax	Florida Sales Tax (FL3)
FL4	Florida Sales Tax	Florida Sales Tax (FL4)
FL5	Florida Sales Tax	Florida Sales Tax (FL5)
GA	Georgia Sales Tax	Georgia Sales Tax (GA)
GA1	Georgia Sales Tax	Georgia Sales Tax (GA1)
GA2	Georgia Sales Tax	Georgia Sales Tax (GA2)
GA3	Georgia Sales Tax	Georgia Sales Tax (GA3)
GA4	Georgia Sales Tax	Georgia Sales Tax (GA4)
GP	GP	GP (GP)
GP1	GSTPST1	GSTPST1 (GP1)
GP2	GSTPST2	GSTPST2 (GP2)
GP3	GSTPST3	GSTPST3 (GP3)
GP4	GSTPST4	GSTPST4 (GP4)
GST	Goods & Services Tax	Goods & Services Tax (GST)
HI	Hawaii Sales Tax	Hawaii Sales Tax (HI)
HI1	Hawaii Sales Tax	Hawaii Sales Tax (HI1)
HST	Harmonized Sales Tax	Harmonized Sales Tax (HST)
HSTBC	BC Harmonized Sales Tax 83790 4325	BC Harmonized Sales Tax 83790 4325 (HSTBC)
HSTNB	NB Harmonized Sales Tax 83790 4325	NB Harmonized Sales Tax 83790 4325 (HSTNB)
HSTNF	NF Harmonized Sales Tax 83790 4325	NF Harmonized Sales Tax 83790 4325 (HSTNF)
HSTNS	NS Harmonized Sales Tax 83790 4325	NS Harmonized Sales Tax 83790 4325 (HSTNS)
HSTON	ON Harmonized Sales Tax 83790 4325	ON Harmonized Sales Tax 83790 4325 (HSTON)
IA	Iowa Sales Tax	Iowa Sales Tax (IA)
IA1	Iowa Sales Tax	Iowa Sales Tax (IA1)
IA3	Iowa Sales Tax	Iowa Sales Tax (IA3)
IA4	Iowa Sales Tax	Iowa Sales Tax (IA4)
ID	Idaho Sales Tax	Idaho Sales Tax (ID)
ID1	Idaho Sales Tax	Idaho Sales Tax (ID1)
IL	Illinois Sales Tax	Illinois Sales Tax (IL)
IL1	Illinois Sales Tax	Illinois Sales Tax (IL1)
IN	Indiana Sales Tax	Indiana Sales Tax (IN)
KS	Kansas Sales Tax	Kansas Sales Tax (KS)
KS1	Kansas Sales Tax	Kansas Sales Tax (KS1)
KS10	Kansas Sales Tax	Kansas Sales Tax (KS10)
KS11	Kansas Sales Tax	Kansas Sales Tax (KS11)
KS12	Kansas Sales Tax	Kansas Sales Tax (KS12)
KS13	Kansas Sales Tax	Kansas Sales Tax (KS13)
KS14	Kansas Sales Tax	Kansas Sales Tax (KS14)
KS15	Kansas Sales Tax	Kansas Sales Tax (KS15)
KS16	Kansas Sales Tax	Kansas Sales Tax (KS16)
KS17	Kansas Sales Tax	Kansas Sales Tax (KS17)
KS18	Kansas Sales Tax	Kansas Sales Tax (KS18)
KS19	Kansas Sales Tax	Kansas Sales Tax (KS19)
KS2	Kansas Sales Tax	Kansas Sales Tax (KS2)
KS20	Kansas Sales Tax	Kansas Sales Tax (KS20)
KS21	Kansas Sales Tax	Kansas Sales Tax (KS21)
KS22	Kansas Sales Tax	Kansas Sales Tax (KS22)
KS23	Kansas Sales Tax	Kansas Sales Tax (KS23)
KS24	Kansas Sales Tax	Kansas Sales Tax (KS24)
KS25	Kansas Sales Tax	Kansas Sales Tax (KS25)
KS26	Kansas Sales Tax	Kansas Sales Tax (KS26)
KS3	Kansas Sales Tax	Kansas Sales Tax (KS3)
KS4	Kansas Sales Tax	Kansas Sales Tax (KS4)
KS5	Kansas Sales Tax	Kansas Sales Tax (KS5)
KS6	Kansas Sales Tax	Kansas Sales Tax (KS6)
KS7	Kansas Sales Tax	Kansas Sales Tax (KS7)
KS8	Kansas Sales Tax	Kansas Sales Tax (KS8)
KS9	Kansas Sales Tax	Kansas Sales Tax (KS9)
KY	Kentucky Sales Tax	Kentucky Sales Tax (KY)
LA	Louisiana Sales Tax	Louisiana Sales Tax (LA)
LA1	Louisiana Sales Tax	Louisiana Sales Tax (LA1)
MA	Massachusetts Sales Tax	Massachusetts Sales Tax (MA)
MD	Maryland Sales Tax	Maryland Sales Tax (MD)
ME	Maine Sales Tax	Maine Sales Tax (ME)
MI	Michigan	Michigan (MI)
MN	Minnesota Sales Tax	Minnesota Sales Tax (MN)
MN1	Minnesota Sales Tax	Minnesota Sales Tax (MN1)
MN2	Minnesota Sales Tax	Minnesota Sales Tax (MN2)
MN3	Minnesota Sales Tax	Minnesota Sales Tax (MN3)
MN4	Minnesota Sales Tax	Minnesota Sales Tax (MN4)
MN5	Minnesota Sales Tax	Minnesota Sales Tax (MN5)
MN6	Minnesota Sales Tax	Minnesota Sales Tax (MN6)
MO	Missouri Sales Tax	Missouri Sales Tax (MO)
MO1	Missouri Sales Tax	Missouri Sales Tax (MO1)
MO10	Missouri Sales Tax	Missouri Sales Tax (MO10)
MO11	Missouri Sales Tax	Missouri Sales Tax (MO11)
MO12	Missouri Sales Tax	Missouri Sales Tax (MO12)
MO13	Missouri Sales Tax	Missouri Sales Tax (MO13)
MO14	Missouri Sales Tax	Missouri Sales Tax (MO14)
MO15	Missouri Sales Tax	Missouri Sales Tax (MO15)
MO16	Missouri Sales Tax	Missouri Sales Tax (MO16)
MO17	Missouri Sales Tax	Missouri Sales Tax (MO17)
MO18	Missouri Sales Tax	Missouri Sales Tax (MO18)
MO19	Missouri Sales Tax	Missouri Sales Tax (MO19)
MO2	Missouri Sales Tax	Missouri Sales Tax (MO2)
MO20	Missouri Sales Tax	Missouri Sales Tax (MO20)
MO21	Missouri Sales Tax	Missouri Sales Tax (MO21)
MO22	Missouri Sales Tax	Missouri Sales Tax (MO22)
MO23	Missouri Sales Tax	Missouri Sales Tax (MO23)
MO24	Missouri Sales Tax	Missouri Sales Tax (MO24)
MO25	Missouri Sales Tax	Missouri Sales Tax (MO25)
MO26	Missouri Sales Tax	Missouri Sales Tax (MO26)
MO27	Missouri Sales Tax	Missouri Sales Tax (MO27)
MO28	Missouri Sales Tax	Missouri Sales Tax (MO28)
MO29	Missouri Sales Tax	Missouri Sales Tax (MO29)
MO3	Missouri Sales Tax	Missouri Sales Tax (MO3)
MO30	Missouri Sales Tax	Missouri Sales Tax (MO30)
MO31	Missouri Sales Tax	Missouri Sales Tax (MO31)
MO32	Missouri Sales Tax	Missouri Sales Tax (MO32)
MO33	Missouri Sales Tax	Missouri Sales Tax (MO33)
MO34	Missouri Sales Tax	Missouri Sales Tax (MO34)
MO35	Missouri Sales Tax	Missouri Sales Tax (MO35)
MO4	Missouri Sales Tax	Missouri Sales Tax (MO4)
MO5	Missouri Sales Tax	Missouri Sales Tax (MO5)
MO6	Missouri Sales Tax	Missouri Sales Tax (MO6)
MO7	Missouri Sales Tax	Missouri Sales Tax (MO7)
MO8	Missouri Sales Tax	Missouri Sales Tax (MO8)
MO9	Missouri Sales Tax	Missouri Sales Tax (MO9)
MS	Mississippi Sales Tax	Mississippi Sales Tax (MS)
MT	Montana	Montana (MT)
NC	North Carolina Sales Tax	North Carolina Sales Tax (NC)
NC1	North Carolina Sales Tax	North Carolina Sales Tax (NC1)
NC2	North Carolina Sales Tax	North Carolina Sales Tax (NC2)
NC3	North Carolina Sales Tax	North Carolina Sales Tax (NC3)
ND	North Dakota Sales Tax	North Dakota Sales Tax (ND)
ND1	North Dakota Sales Tax	North Dakota Sales Tax (ND1)
ND2	North Dakota Sales Tax	North Dakota Sales Tax (ND2)
ND3	North Dakota Sales Tax	North Dakota Sales Tax (ND3)
ND4	North Dakota Sales Tax	North Dakota Sales Tax (ND4)
ND5	North Dakota Sales Tax	North Dakota Sales Tax (ND5)
ND6	North Dakota Sales Tax	North Dakota Sales Tax (ND6)
ND7	North Dakota Sales Tax	North Dakota Sales Tax (ND7)
ND8	North Dakota Sales Tax	North Dakota Sales Tax (ND8)
ND9	North Dakota	North Dakota (ND9)
NE	Nebraska Sales Tax	Nebraska Sales Tax (NE)
NE1	Nebraska Sales Tax	Nebraska Sales Tax (NE1)
NE2	Nebraska Sales Tax	Nebraska Sales Tax (NE2)
NE3	Nebraska Sales Tax	Nebraska Sales Tax (NE3)
NE4	Nebraska Sales Tax	Nebraska Sales Tax (NE4)
NH	New Hampshire Sales Tax	New Hampshire Sales Tax (NH)
NJ	New Jersey Sales Tax	New Jersey Sales Tax (NJ)
NM	New Mexico Sales Tax	New Mexico Sales Tax (NM)
NV	Nevada Sales Tax	Nevada Sales Tax (NV)
NV1	Nevada Sales Tax	Nevada Sales Tax (NV1)
NV2	Nevada Sales Tax	Nevada Sales Tax (NV2)
NV3	Nevada Sales Tax	Nevada Sales Tax (NV3)
NV4	Nevada Sales Tax	Nevada Sales Tax (NV4)
NV5	Nevada Sales Tax	Nevada Sales Tax (NV5)
NV6	Nevada Sales Tax	Nevada Sales Tax (NV6)
NV7	Nevada Sales Tax	Nevada Sales Tax (NV7)
NY	New York Sales Tax	New York Sales Tax (NY)
NY1	New York Sales Tax	New York Sales Tax (NY1)
NY10	New York Sales Tax	New York Sales Tax (NY10)
NY11	New York Sales Tax	New York Sales Tax (NY11)
NY12	New York Sales Tax	New York Sales Tax (NY12)
NY13	New York Sales Tax	New York Sales Tax (NY13)
NY14	New York Sales Tax	New York Sales Tax (NY14)
NY15	New York Sales Tax	New York Sales Tax (NY15)
NY2	New York Sales Tax	New York Sales Tax (NY2)
NY3	New York Sales Tax	New York Sales Tax (NY3)
NY4	New York Sales Tax	New York Sales Tax (NY4)
NY5	New York Sales Tax	New York Sales Tax (NY5)
NY6	New York Sales Tax	New York Sales Tax (NY6)
NY7	New York Sales Tax	New York Sales Tax (NY7)
NY8	New York Sales Tax	New York Sales Tax (NY8)
NY9	New York Sales Tax	New York Sales Tax (NY9)
OH	Ohio Sales Tax	Ohio Sales Tax (OH)
OH1	Ohio Sales Tax	Ohio Sales Tax (OH1)
OH10	Ohio Sales Tax	Ohio Sales Tax (OH10)
OH2	Ohio Sales Tax	Ohio Sales Tax (OH2)
OH3	Ohio Sales Tax	Ohio Sales Tax (OH3)
OH4	Ohio Sales Tax	Ohio Sales Tax (OH4)
OH5	Ohio Sales Tax	Ohio Sales Tax (OH5)
OH6	Ohio Sales Tax	Ohio Sales Tax (OH6)
OH7	Ohio Sales Tax	Ohio Sales Tax (OH7)
OH8	Ohio Sales Tax	Ohio Sales Tax (OH8)
OH9	Ohio Sales Tax	Ohio Sales Tax (OH9)
OK	Oklahoma Sales Tax	Oklahoma Sales Tax (OK)
OK1	Oklahoma Sales Tax	Oklahoma Sales Tax (OK1)
OK10	Oklahoma Sales Tax	Oklahoma Sales Tax (OK10)
OK11	Oklahoma Sales Tax	Oklahoma Sales Tax (OK11)
OK12	Oklahoma Sales Tax	Oklahoma Sales Tax (OK12)
OK13	Oklahoma Sales Tax	Oklahoma Sales Tax (OK13)
OK14	Oklahoma Sales Tax	Oklahoma Sales Tax (OK14)
OK15	Oklahoma Sales Tax	Oklahoma Sales Tax (OK15)
OK16	Oklahoma Sales Tax	Oklahoma Sales Tax (OK16)
OK17	Oklahoma Sales Tax	Oklahoma Sales Tax (OK17)
OK18	Oklahoma Sales Tax	Oklahoma Sales Tax (OK18)
OK19	Oklahoma Sales Tax	Oklahoma Sales Tax (OK19)
OK2	Oklahoma Sales Tax	Oklahoma Sales Tax (OK2)
OK20	Oklahoma Sales Tax	Oklahoma Sales Tax (OK20)
OK21	Oklahoma Sales Tax	Oklahoma Sales Tax (OK21)
OK22	Oklahoma Sales Tax	Oklahoma Sales Tax (OK22)
OK23	Oklahoma Sales Tax	Oklahoma Sales Tax (OK23)
OK24	Oklahoma Sales Tax	Oklahoma Sales Tax (OK24)
OK25	Oklahoma Sales Tax	Oklahoma Sales Tax (OK25)
OK26	Oklahoma Sales Tax	Oklahoma Sales Tax (OK26)
OK27	Oklahoma Sales Tax	Oklahoma Sales Tax (OK27)
OK28	Oklahoma Sales Tax	Oklahoma Sales Tax (OK28)
OK29	Oklahoma Sales Tax	Oklahoma Sales Tax (OK29)
OK3	Oklahoma Sales Tax	Oklahoma Sales Tax (OK3)
OK30	Oklahoma Sales Tax	Oklahoma Sales Tax (OK30)
OK31	Oklahoma Sales Tax	Oklahoma Sales Tax (OK31)
OK32	Oklahoma Sales Tax	Oklahoma Sales Tax (OK32)
OK33	Oklahoma Sales Tax	Oklahoma Sales Tax (OK33)
OK34	Oklahoma Sales Tax	Oklahoma Sales Tax (OK34)
OK35	Oklahoma Sales Tax	Oklahoma Sales Tax (OK35)
OK36	Oklahoma Sales Tax	Oklahoma Sales Tax (OK36)
OK37	Oklahoma Sales Tax	Oklahoma Sales Tax (OK37)
OK38	Oklahoma	Oklahoma (OK38)
OK39	Oklahoma	Oklahoma (OK39)
OK4	Oklahoma Sales Tax	Oklahoma Sales Tax (OK4)
OK40	Oklahoma Sales Tax	Oklahoma Sales Tax (OK40)
OK41	Oklahoma Sales Tax	Oklahoma Sales Tax (OK41)
OK5	Oklahoma Sales Tax	Oklahoma Sales Tax (OK5)
OK6	Oklahoma Sales Tax	Oklahoma Sales Tax (OK6)
OK7	Oklahoma Sales Tax	Oklahoma Sales Tax (OK7)
OK8	Oklahoma Sales Tax	Oklahoma Sales Tax (OK8)
OK9	Oklahoma Sales Tax	Oklahoma Sales Tax (OK9)
OR	Oregon	Oregon (OR)
PA	Pennsylvania Sales Tax	Pennsylvania Sales Tax (PA)
PA1	Pennsylvania Sales Tax	Pennsylvania Sales Tax (PA1)
PA2	Pennsylvania Sales Tax	Pennsylvania Sales Tax (PA2)
PST	Provincial Sales Tax	Provincial Sales Tax (PST)
RI	Rhode Island Sales Tax	Rhode Island Sales Tax (RI)
SC	South Carolina Sales Tax	South Carolina Sales Tax (SC)
SC1	South Carolina Sales Tax	South Carolina Sales Tax (SC1)
SC2	South Carolina Sales Tax	South Carolina Sales Tax (SC2)
SC3	South Carolina Sales Tax	South Carolina Sales Tax (SC3)
SC4	South Carolina	South Carolina (SC4)
SD	South Dakota Sales Tax	South Dakota Sales Tax (SD)
SD1	South Dakota Sales Tax	South Dakota Sales Tax (SD1)
SD2	South Dakota Sales Tax	South Dakota Sales Tax (SD2)
SD3	South Dakota Sales Tax	South Dakota Sales Tax (SD3)
SD4	South Dakota Sales Tax	South Dakota Sales Tax (SD4)
SD5	South Dakota Sales Tax	South Dakota Sales Tax (SD5)
SD6	South Dakota Sales Tax	South Dakota Sales Tax (SD6)
TN	Tennessee Sales Tax	Tennessee Sales Tax (TN)
TN1	Tennessee Sales Tax	Tennessee Sales Tax (TN1)
TN2	Tennessee Sales Tax	Tennessee Sales Tax (TN2)
TN3	Tennessee Sales Tax	Tennessee Sales Tax (TN3)
TN4	Tennessee Sales Tax	Tennessee Sales Tax (TN4)
TN5	Tennessee Sales Tax	Tennessee Sales Tax (TN5)
TX	Texas Sales Tax	Texas Sales Tax (TX)
TX1	Texas Sales Tax	Texas Sales Tax (TX1)
TX2	Texas Sales Tax	Texas Sales Tax (TX2)
TX3	Texas Sales Tax	Texas Sales Tax (TX3)
TX4	Texas Sales Tax	Texas Sales Tax (TX4)
TX5	Texas Sales Tax	Texas Sales Tax (TX5)
TX6	Texas Sales Tax	Texas Sales Tax (TX6)
TX7	Texas Sales Tax	Texas Sales Tax (TX7)
TX8	Texas Sales Tax	Texas Sales Tax (TX8)
TX9	Texas	Texas (TX9)
UT	Utah Sales Tax	Utah Sales Tax (UT)
UT1	Utah Sales Tax	Utah Sales Tax (UT1)
UT10	Utah Sales Tax	Utah Sales Tax (UT10)
UT11	Utah Sales Tax	Utah Sales Tax (UT11)
UT12	Utah Sales Tax	Utah Sales Tax (UT12)
UT13	Utah Sales Tax	Utah Sales Tax (UT13)
UT14	Utah Sales Tax	Utah Sales Tax (UT14)
UT15	Utah Sales Tax	Utah Sales Tax (UT15)
UT16	Utah Sales Tax	Utah Sales Tax (UT16)
UT17	Utah Sales Tax	Utah Sales Tax (UT17)
UT2	Utah Sales Tax	Utah Sales Tax (UT2)
UT3	Utah Sales Tax	Utah Sales Tax (UT3)
UT4	Utah Sales Tax	Utah Sales Tax (UT4)
UT5	Utah Sales Tax	Utah Sales Tax (UT5)
UT6	Utah Sales Tax	Utah Sales Tax (UT6)
UT7	Utah Sales Tax	Utah Sales Tax (UT7)
UT8	Utah Sales Tax	Utah Sales Tax (UT8)
UT9	Utah Sales Tax	Utah Sales Tax (UT9)
VA	Virginia Sales Tax	Virginia Sales Tax (VA)
VT	Vermont Sales Tax	Vermont Sales Tax (VT)
WA	Washington Sales Tax	Washington Sales Tax (WA)
WA1	Washington Sales Tax	Washington Sales Tax (WA1)
WA10	Washington Sales Tax	Washington Sales Tax (WA10)
WA11	Washington Sales Tax	Washington Sales Tax (WA11)
WA12	Washington Sales Tax	Washington Sales Tax (WA12)
WA13	Washington Sales Tax	Washington Sales Tax (WA13)
WA14	Washington Sales Tax	Washington Sales Tax (WA14)
WA15	Washington Sales Tax	Washington Sales Tax (WA15)
WA16	Washington Sales Tax	Washington Sales Tax (WA16)
WA2	Washington Sales Tax	Washington Sales Tax (WA2)
WA3	Washington Sales Tax	Washington Sales Tax (WA3)
WA4	Washington Sales Tax	Washington Sales Tax (WA4)
WA5	Washington Sales Tax	Washington Sales Tax (WA5)
WA6	Washington Sales Tax	Washington Sales Tax (WA6)
WA7	Washington Sales Tax	Washington Sales Tax (WA7)
WA8	Washington Sales Tax	Washington Sales Tax (WA8)
WA9	Washington Sales Tax	Washington Sales Tax (WA9)
WAUSE	Washington Use Tax	Washington Use Tax (WAUSE)
WI	Wisconsin Sales Tax	Wisconsin Sales Tax (WI)
WI1	Wisconsin Sales Tax	Wisconsin Sales Tax (WI1)
WI2	Wisconsin Sales Tax	Wisconsin Sales Tax (WI2)
WI3	Wisconsin Sales Tax	Wisconsin Sales Tax (WI3)
WV	West Virginia Sales Tax	West Virginia Sales Tax (WV)
WY	Wyoming Sales Tax	Wyoming Sales Tax (WY)
VATUK	VAT UK	VAT UK (VATUK)
VATNL	VAT NL	VAT NL (VATNL)
AEX	AUS Exempt	AUS Exempt (AEX)
AGST	Australian GST	Australian GST (AGST)
VATFR	VAT FR	VAT FR (VATFR)